38,19,4

   WWWWWWWWWWWWWWWWWWWWWWWWWW   WWWWW 
  W                         WWWW     W
  W WWWWWWWWWWWWWW WWWW          b R W
 WW WW           W W  W     WWWW     W
W     W  WWWWWWWWW W  W WWWWW   WWWWW 
W W W W W          W  W W             
W     W W    WWWWWW  W   W            
W W W W W        W   W W W            
W     W  WWWWW   W  WW W W            
W W W W  W   W   W W   WW             
W     W  W B WWW W W WW               
W WrW WWWW   WWW W W W                
W                W W W                
 WW WWWWWW   WWW WWW W                
  W W     W W  W     W                
  W W     W W   WWWWW                 
 W   W   W   W                        
 W E W   W S W                        
  WWW     WWW                         

   WWWWWWWWWWWWWWWWWWWWWWWWWW   WWWWW 
  W                         WWWW     W
  W WWWWWWWWWWWWWW WWWW              W
 WW WW           W W  W     WWWW     W
W     W  WWWWWWWWW W  W WWWWW   WWWWW 
W W W W W          W  W W             
W     W W    WWWWWW  W   W            
W W W W W        W   W W W            
W     W  WWWWW   W  WW W W            
W W W W  W   W   W W   WW             
W     W  W   WWW W W WW               
W W W WWWW   WWW W W W                
W                W W W                
 WW WWWWWW   WWW WWW W                
  W W     W W  W     W                
  W W     W W   WWWWW                 
 W   W   W   W                        
 W   W   W   W                        
  WWW     WWW                         

                                      
   WWWWWWWWWWWWWWWWWWWWWWWWWWWWW      
   WWWWWWWWWWWWWWWWWWWWWWWWWWWWW      
  WWWW                WWWWWW          
W     W               WW              
W W W W               WW              
W     W         WWW  WWWW             
W W W W   WWWWWWW    WWWW             
W     W   WWWW      WWWWW             
W W W W   WWWW     WWWWW              
W     W   WWWWWW   WWW                
W W W W   WWWWWW   WW                 
W     W  WWWWWWWW  WW                 
 WWWWWWWWWWWWWWWWWWWW                 
   W       W    WWWWW                 
   W       W                          
  WWW     WWW                         
  WWW     WWW                         
                                      

                                      
                                      
                                      
                                      
WWWWWWW                               
WWWWWWW                               
WWWWWWW                               
WWWWWWW                               
WWWWWWW                               
WWWWWWW                               
WWWWWWW                               
WWWWWWW                               
WWWWWW           W W W                
                                      
                                      
                                      
                                      
                                      
                                      

